2222222222222222222
2001100011000011002
2001100011000011002
2000000011000000002
2000000011000000002
2000000011000000002
2000000000000000002
2001100000000011002
2001100000000011002
2001100000000011002
2001100000000011002
2000000000000000002
2000000001100000002
2000000001100000002
2000000001100000002
2001100001100011002
2001100001100011002
2222222222222222222
