0000100000010000
0000100000010000
0011100000011100
0000000000000000
0000000000000000
0000000000000000
0000000000000000
0000000000000000
0000000000000000
0011100000011100
0000100000010000
0000100000010000